..###...
..#x#...
..#.####
###X.Xx#
#x.XP###
####X#..
...#x#..
...###..
