..###...
.##x#...
.#.X####
##...XP#
#x.XXx##
####.##.
...#x#..
...###..
