########.
#P.R..r##
#.X#Gx#g#
#..B..b.#
##......#
.########
